########
# .. p #
# oo   #
#      #
########