########
# ..O  #
# oo p #
#      #
########