########
# ..   #
# oo   #
#    p #
########