#############
# ...       #
# ooo  p    #
#           #
#############