###########
# ..   #. #
# oo   #o #
#    p    #
###########